╔═══════════════════════════════════════════════════════════════════════════════════════════╗
║                                                                                           ║
║              __                                _          __                              ║
║             /__\ ___  __ _ _ __ __ _ ___    __| | ___     \ \  ___   __ _  ___            ║
║            / \/// _ \/ _` | '__/ _` / __|  / _` |/ _ \     \ \/ _ \ / _` |/ _ \           ║
║           / _  \  __/ (_| | | | (_| \__ \ | (_| | (_) | /\_/ / (_) | (_| | (_) |          ║
║           \/ \_/\___|\__, |_|  \__,_|___/  \__,_|\___/  \___/ \___/ \__, |\___/           ║
║                      |___/                                          |___/                 ║
║                                                                                           ║
║                                                                                           ║
║      🎯 Missões são quizzes sobre temas de cada estágio da disciplina PLP                 ║
║      🔒 Missões são desbloqueadas uma por vez — conclua uma para liberar a próxima!       ║
║      ❗ Limite de erros por missão:                                                       ║
║           🟢 Fácil: até 3 erros                                                           ║
║           🟡 Médio: até 2 erros                                                           ║
║           🔴 Difícil: 1 erro"                                                             ║
║       💥 Se ultrapassar o limite, a missão reinicia do zero                               ║
║       🏆 Vença chefões e conquiste medalhas com seu desempenho                            ║
║       📚 Revise perguntas erradas no modo Treino (flashcards)                             ║
║       📈 Aprenda jogando e avance até o final da jornada!                                 ║
║                                                                                           ║
║                                                                                           ║
║                                                                                           ║
║                                                                                           ║
╚═══════════════════════════════════════════════════════════════════════════════════════════╝
